示相化石|環境を知る手がかりとなる化石。??になるのは限られた環境でしか生存できない生物である
示準化石|時代を知る手がかりとなる化石。??になるのは限られた時代に、広い地域に生存していた生物である
古生代|フズリナ、三葉虫
中生代|アンモナイト、恐竜
新生代|ビカリア、マンモス
風化|地表の岩石が太陽の熱や風雨の働きで表面からぼろぼろにくずれ砂や泥に変わっていくこと
侵食|風化した岩石を雨水や流水が削り取ること。革の上流で侵食がさかんに行われる。
運搬|侵食によって削りとられたれき、砂、ドロが革によって運ばれること
堆積|流れがゆるやかになった河口や海の底に、れき、砂、ドロが平らに積もっていくこと
かぎ層|離れた地層を比較する手がかりとなる地層のことを??という
堆積岩|地層として堆積した土砂が長い年月おし固められてできた岩石
チャート|??と石灰岩は生物の遺骸が水に溶けて固まったものである。??の主な成分は二酸化ケイ素
石灰岩|チャートと??は生物の遺骸が水に溶けて固まったものである。??の主な成分は炭酸カルシウムで、柔らかく容易に傷がつき、塩酸ｎをかけると二酸化炭素が発生する。
凝灰岩|火山灰など火山噴出物が堆積したもの
しゅう曲|長期間大きな力を受けて地層が波打つようにまがったもの
断層|岩盤や地層が大きな力をうけて断ち切られてたもの
隆起|土地が周囲よりも上がること。地震によっておきたり、長時間にわたってゆっくり起こる場合もある。
沈降|土地が周囲よりも下がること
海岸段丘|波による侵食と海岸線の隆起によってできた階段上の地形
P波|伝わる速さの早い波、小さな揺れを起こす
S波|伝わる速さの遅い波、おおきなゆれを起こす
初期微動|P波
主要動|S波
初期微動継続時間|P波とS波の到達時刻の差。??は震源からの距離に比例する
震度|ある地点でのゆれの強さを表す。0-7まで10段階にわけられる(5,6は弱と強がある)
マグニチュード|地震の規模、エネルギーの大きさを表す。??が1増えるとエネルギーは約32倍になる
断層|地震によって起こった大地のずれ。岩盤、地層がおおきな力によって断ち切られてずれる。正断層、逆断層
活断層|繰り返し動いか断層。これからも動く可能性があ高いのでそこで地震がおこりやすい。
プレート|地球の表面をおおう、巨大な岩盤.
マグマ|地下の、高温で岩石がどろどろに溶けた物質を?/という
火山噴出物|溶岩や火山灰や火山弾や軽石や火山ガスなど
溶岩|火口から流れ出す高温の液体状のもの、またそれが固まったもの
火山灰、火山れき|個体。2mm以下が??、それ以上が??
火山弾|白っぽく小さな穴がたくさん開いていて軽い
火山ガス|期待。水上機が大部分で、二酸化炭素や二酸化硫黄などを含む
マグマだまり|地下数kmに??があり、マグマが一時たくわえられている
火成岩|マグマが固まってできた岩石を火成岩という
火山岩|火成岩のうち、地下の浅いところや地上で急に冷え固まった岩石。
斑状組織|火山岩の組織。地下にあるときに成長した斑晶と地表近くで急に冷えて釜たったために結晶になれなかった部分石基からできている。白い法から順に流紋岩、安山岩、玄武岩である
深成岩|火成岩のうち、地下の深いところでゆっくり冷えて固まった岩石を深成岩という。
等粒状組織|深成岩の組織。白い方から順にかこう岩、閃緑岩、斑れい岩
無色鉱物|セキエイ、チョウ石
有色鉱物|クロウンモ、カクセン石、キ石、カンラン石
